111111111111111111111111111111
100000000000000000000000100E01
100H000C0C0C000000000000100001
100000000011100011100000100001
100000P00010000000100000000001
10000000001000C000100000000001
100000000010000000100000000001
100000000010000000100000000001
111111111111111111111111111111